20 20
0 0
11 12 11 12 11 12 11 12 11 12 11 12 11 12 11 12 11 12 11 12
21 22 21 22 21 22 21 22 21 22 21 22 21 22 21 22 21 22 21 22
31 32 31 32 31 32 31 32 31 32 31 32 31 32 31 32 31 32 31 32
11 12 0 0 0 0 0 0 0 0 0 0 0 0 0 0 0 0 11 12
21 22 0 0 0 0 0 0 0 0 0 0 0 0 0 0 0 0 21 22
31 32 0 0 0 0 0 0 0 0 0 0 0 0 0 0 0 0 31 32
11 12 0 0 0 0 0 0 0 0 0 0 0 0 0 0 0 0 11 12
21 22 0 0 0 0 0 0 0 0 0 0 0 0 0 0 0 0 21 22
31 32 0 0 0 0 0 0 0 0 0 0 0 0 0 0 0 0 31 32
11 12 0 0 0 0 0 0 0 0 0 0 0 0 0 0 0 0 11 12
21 22 0 0 0 0 0 0 0 0 0 0 0 0 0 0 0 0 21 22
31 32 0 0 0 0 0 0 0 0 0 0 0 0 0 0 0 0 31 32
11 12 0 0 0 0 0 0 0 0 0 0 0 0 0 0 0 0 11 12
21 22 0 0 0 0 0 0 0 0 0 0 0 0 0 0 0 0 21 22
31 32 0 0 0 0 0 0 0 0 0 0 0 0 0 0 0 0 31 32
11 12 0 0 0 0 0 0 0 0 0 0 0 0 0 0 0 0 11 12
21 22 0 0 0 0 0 0 0 0 0 0 0 0 0 0 0 0 21 22
31 32 0 0 0 0 0 0 0 0 0 0 0 0 0 0 0 0 31 32
11 12 11 12 11 12 11 12 11 12 11 12 11 12 11 12 11 12 11 12
21 22 21 22 21 22 21 22 21 22 21 22 21 22 21 22 21 22 21 22
